6 10 1 1
# # # . . . . . . .
# # # # # # . . . .
# # # # # # # # # .
. # # # # # # # # #
. . . . . # # G # #
. . . . . . # # # .
0