10 12 0 5
. # # # # . . . . . . .
. # G # # . . . . . . .
. # # # . . . . . . . .
. # . . . # # # # # # .
. # . . . # # . . # # .
# # # # # # # . . # # #
. . . . . # o . . . . #
. . . . . # # # # . . #
. . . . . # # # # # # #
. . . . . . . . # # # .
1
{   "switch": "sort_switch",
    "position": [6,6],
    "blocks_process": 2,
    "point": [[4,0],[4,1]],
    "type": "close" }
