6 15 1 3
. . . . . . # # # # # # # . .
# # # # . . # # # . . # # . .
# # # # # # # # # . . # # # #
# # # # . . . . . . . # # G #
# # # # . . . . . . . # # # #
# # # # . . . . . . . . # # #
0