9 14 1 5
. . . = = = = = = = . . . .
. . . = = = = = = = . . . .
# # # # . . . . . # # # . .
# # # . . . . . . . # # . .
# # # . . . . . . . # # . .
# # # . . # # # # = = = = =
# # # . . # # # # = = = = =
. . . . . # G # . . = = # =
. . . . . # # # . . = = = =
0